222
43
333333333333333333333333333333333333333333333333333333333333000000000000000000000000000000000000000000000000000000000000000000000000000000000000000000000000000000000000000000000000000000000000000000000000000000000000000000
333333333333333333333333333333333333333333333333333333333333000000000000000000000000000000000000000000000000000000000000000000000000000000000000000000000000000000000000000000000000000000000000000000000000000000000000000000
000000000000000000000000000000000000000000000000000000000033000000000000000000000000000000000000000000000000000000000000000000000000000000000000000000000000000000000000000000000000000000000000000000000000000000000000000000
000000000000000000000000000000000000000000000000000000000033000000000000000000000000000000000000000000000000000000000000000000000000000000000000000000000000000000000000000000000000000000000000000000000000000000000000000000
000000000000000000000000000000000000000000000000000000000033000000000000000000000000000000000000000000000000000000000000000000000000000000000000000000000000000000000000000000000000000000000000000000000000000000000000000000
000000000000000000000000000000000000000000000000000000000033000000000000000000000000000000000000000000000000000000000000000000000000000000000000000000000000000000000000000000000000000000000000000000000000000000000000000000
000000000000000000000000000000000000000000000000000000000033000000000000000000000000000000000000000000000000000000000000000000000000000000000000000000000000000000000000000000000000000000000000000000000000000000000000000000
000000000000000000000000000000000000000000000000000000000033000000000000000000000000000000000000000000000000000000000000000000000000000000000000000000000000000000000000000000000000000000000000000000000000000000000000000000
222222222222000000000000000000000000000000000000000000000033000000000000000000000000000000000000000000000000000000000000000000000000000000000000000000000000000000000000000000000000000000000000000000000000000000000000000000
333333333333000000000000000000000000000000000000000000000033333333333333333333333333000000000000000000000000000000000000000000000000000000000000000000000000000000000000000000000000000000000000000000000000000000000000000000
000000000033000000000000000000000000000000000000000000000033333333333333333333333333000000000000000000000000000000000000000000000000000000000000000000000000000000000000000000000000000000000000000000000000000000000000000000
000000000033000000222220000000000000000000000000000004400000000000000044000000000033000000000000000000000000000000000000000000000000000000000000000000000000000000000000000000000000000000000000000000000000000000000000000000
000000000033000000333330000000000000000000000000000004400000000000000044000000000033000000000000000000000000000000000000000000000000000000000000000000000000000000000000000000000000000000000000000000000000000000000000000000
000000000033000000000000000000222220000000000000000004400000000000000044000000000033000000000000000000000000000000000000000000000000000000000000000000000000000000000000000000000000000000000000000000000000000000000000000000
000000000033000000000000000000333330000000000000000004400000000000000044000000000033000000000000000000000000000000000000000000000000000000000000000000000000000000000000000000000000000000000000000000000000000000000000000000
000000000033000000000000000000000000000000222220000004400000000000000044000000000033000000000000000000000000000000000000000000000000000000000000000000000000000000000000000000000000000000000000000000000000000000000000000000
000000000033111100000000000000000000000000333330000004400000000000000044000000000033000000000000000000000000000000000000000000000000000000000000000000000000000000000000000000000000000000000000000000000000000000000000000000
000000000033000011111110000000000000000000000000000002222222222222222222222000000033000000000000000000000000000000000000000000000000000000000000000000000000000000000000000000000000000000000000000000000000000000000000000000
000000000033000000000001111100000000000000000000000003333333333333333333333000000033000000000000000000000000000000000000000000000000000000000000000000000000000000000000000000000000000000000000000000000000000000000000000000
000000000033000000000000000011111110000000000000000003300000000000330000000000000033333333333333333333333333333333333333333333333300000000000000000000000000000000000000000000000000000000000000000000000000000000000000000000
000000000033000000000000000000000001111100000000000003300000000000330000000000000033333333333333333333333333333333333333333333333300000000000000000000000000000000000000000000000000000000000000000000000000000000000000000000
000000000033000000000000000000000000000011111111111113300000000000330000000000000000000000000004400000000000000000000000000000003300000000000000000000000000000000000000000000000000000000000000000000000000000000000000000000
000000000033000000000000000000000000000000000000000003300000000000330000000000000000000000000004400000000000000000000000000000003300000000000000000000000000000000000000000000000000000000000000000000000000000000000000000000
000000000033000000000000000000000000000000000000000003300000000000330000000000000000000000000004400000000000000000000000000000003300000000000000000000000000000000000000000000000000000000000000000000000000000000000000000000
000000000033000000000000000000000000000000000000000003300000000000330000000000000000000000000004400000000000000000000000000000003333333333333333333333333333333333333333333333333333333333333333333333333333333333333333333333
000000000033000000000000000000000000000000000000000003300000000000330000000000000000000000000004400000000000000000000000000000003333333333333333333333333333333333333333333333333333333333333333333333333333333333333333333333
000000000033000000000000000000000000000000000000000003300000000000330000000000000000000000000004400000000000000000000000000000000000000000044000000000000000000000000000000000000000000000000000000000000004400000000000000000
000000000033000000000000000000000000000000000000000003300000000000332222222222222222222222222222222200000000000000000000000000000000000000044000000000000000000000000000000000000000000000000000000000000004400000000000000000
000000000033000000000000000000000000000000000000000003300000000000333333333333333333333333333333333300000000000000000000000000000000000000044000000000000000000000000000000000000000000000000000000000000004400000000000000000
000000000033000000000000000000000000000000000000000003300000000000000000000000000000033000000000000022000000000000000000000000000000000000044000000000000000000000000000000000000000000000000000000000000004400000000000000000
000000000000000000000000000000000000000000000000000000000000000000000000000000000000033000000000000000000000000000000000000000000000000000044000000000000000000000000000000000000000000000000000000000000004400000000000000000
000000000000000000000000000000000000000000000000000000000000000000000000000000000000033000000000000000220000000000000000000000000000000000044000000000000000000000000000000000000000000000000000000000000004400000000000000000
000000000000000000000000000000000000000000000000000000000000000000000000000000000000033000000000000000000000000000000000000002222222222222222222222222222222222222222222222222222222222222222222222222222222222222222222222222
000000000000000000000000000000000000000000000000000000000000000000000000000000000000033000000000000000002200000000000000000003333333333333333333333333333333333333333333333333333333333333333333333333333333333333333333333333
000000000000000000000000000000000000000000000000000000000000000000000000000000000000033000000000000000000000000000000000000000000000000000000000003300000000000000000000000000000000000000000000000000000000000000000000000000
000000000000000000000000000000000000000000000000000000000000000000000000000000000000033000000000000000000022000000000000000000000000000000000000003300000000000000000000000000000000000000000000000000000000000000000000000000
000000000000000000000000000000000000000000000000000000000000000000000000000000000000033000000000000000000000000000000000000000000000000000000000003300000000000000000000000000000000000000000000000000000000000000000000000000
000000000000000000000000000000000000000000000000000000000000000000000000000000000000033000000000000000000000220000000000000000000000000000000000003300000000000000000000000000000000000000000000000000000000000000000000000000
000000000000000000000000000000000000000000000000000000000000000000000000000000000000033000000000000000000000000000000000000000000000000000000000003300000000000000000000000000000000000000000000000000000000000000000000000000
000000000000000000000000000000000000000000000000000000000000000000000000000000000000033000000000000000000000002200000000000000000000000000000000003300000000000000000000000000000000000000000000000000000000000000000000000000
000000000000000000000000000000000000000000000000000000000000000000000000000000000000033000000000000000000000000000000000000000000000000000000000003300000000000000000000000000000000000000000000000000000000000000000000000000
000000000000000000000000000000000000000000000000000000000000000000000000000000000000033222222222222222222222222222222222222222222222222222222222223300000000000000000000000000000000000000000000000000000000000000000000000000
000000000000000000000000000000000000000000000000000000000000000000000000000000000000033333333333333333333333333333333333333333333333333333333333333300000000000000000000000000000000000000000000000000000000000000000000000000
