77
49
33333333333333333333333333333333333333333333333333333333333330000000000000000
33333333333333333333333333333333333333333333333333333333333330000000000000000
00440000000000000000000000000000000000000000000000000000000330000000000000000
00440000000000000000000000000000000000000000000000000000000330000000000000000
00440000000000000000000000000000000000000000000000000000000330000000000000000
00440000000000000000000000000000000000000000000000000000000330000000000000000
00440000000000000000000000000000000000000000000000000000000330000000000000000
00440000000000000000000000000000000000000000000000000000000330000000000000000
22222222222222222220000022222222222222222222222222222222222333333000000000000
33333333333333333330000033333333333333333333333333333333333333333000000000000
00000000330000000002200000000000000000000000000004400000000000033000000000000
00000000330000000000000000000000000000000000000004400000000000033000000000000
00000000330000000000022000000000000000000000000004400000000000033000000000000
00000000330000000000000000000000000000000000000004400000000000033000000000000
00000000330000000000000220000000000000000000000004400000000000033000000000000
00000000330000000000000000000000000000000000000004400000000000033000000000000
33333333332222222222222222222222222222222222222222222200000333333000000000000
33333333333333333333333333333333333333333333333333333300000333333000000000000
33000000000000000000000000000000000000000000000000000000000330000000000000000
33000000000000000000000000000000000000000000000000000000000330000000000000000
33000000000000000000000000000000000000000000000000000000000330000000000000000
33000000000000000000000000000000000000000000000000000000000330000000000000000
33000000000000000000000000000000000000000000000000000000000330000000000000000
33000000000000000000000000000000000000000000000000000000000330000000000000000
33222222222222222200000000000000222222222222222222222222222333333333333333333
33333333333333333300000000000000333333333333333333333333333333333333333333333
00000000033000000000000000000000000000000000000000000000000000004400000000033
00000000033000000000000000000000000000000000000000000000000000004400000000033
00000000033000000000000000000000000000000000000000000000000000004400000000033
00000000033000000000000000000000000000000000000000000000000000004400000000033
00000000033000000000000000000000000000000000000000000000000000004400000000033
00000000033000000000000000000000000000000000000000000000000000004400000000033
33333333333222222222222222222222222222222222222222222222222000002222222222233
33333333333333333333333333333333333333333333333333333333333000003333333333333
00000000000000000000000000000000000000044000000000000000000000000003300000000
00000000000000000000000000000000000000044000000000000000000000000003300000000
00000000000000000000000000000000000000044000000000000000000000000003300000000
00000000000000000000000000000000000000044000000000000000000000000003300000000
00000000000000000000000000000000000000044000000000000000000000000003300000000
00000000000000000000000000000000000000044000000000000000000000000003300000000
22222222222222222222222222222222222222222222200000000000000000000003300000000
33333333333333333333333333333333333333333333300000000000000000000003300000000
00000000000000000000000000000000000000000003300000000000000000011113300000000
00000000000000000000000000000000000000000003300000000000111111100003300000000
00000000000000000000000000000000000000000003300000011111000000000003300000000
00000000000000000000000000000000000000000003311111100000000000000003300000000
00000000000000000000000000000000000000000003300000000000000000000003300000000
00000000000000000000000000000000000000000003300000000000000000000003300000000
00000000000000000000000000000000000000000003300000000000000000000003300000000
