160
36
1111111111111111111111111111111111111111111111111111111111111100000000000000000000011111111111111111111111111111111111111111111111111111111111111110000000000000
1111111111111111111111111111111111111111111111111111111111111100000000000000000000011111111111111111111111111111111111111111111111111111111111111110000000000000
0000000000000000000000000000000000000000000000000000000000001100000000000000000000011000000000000000000000000000000000000000000000000000000000000110000000000000
0000000000000000000000000000000000000000000000000000000000001100000000000000000000011000000000000000000000000000000000000000000000000000000000000110000000000000
0000000000000000000000000000000000000000000000000000000000001100000000000000000000011000000000000000000000000000000000000000000000000000000000000110000000000000
0000000000000000000000000000000000000000000000000000000000001100000000000000000000011000000000000000000000000000000000000000000000000000000000000110000000000000
0000000000000000000000000000000000000000000000000000000000001100000000000000000000011000000000000000000000000000000000000000000000000000000000000110000000000000
0000000000000000000000000000000000000000000000000000000000001100000000000000000000011000000000000000000000000000000000000000000000000000000000000110000000000000
0000000000000000000000000000000000000000000000000000000000001100000000000000000000011000000000000000000000000000000000000000000000000000000000000110000000000000
0000000000000000000000000000000000000000000000000000000000001100000000000000000000011000000000000000000000000000000000000000000000000000000000000110000000000000
1111111111111111000000000000000000000111111111111111111111111100000000000000000000011000000000000000000000000000000000000000000000000000000000000110000000000000
1111111111111111000000000000000000000111111111111111111111111100000000000000000000011000000000000000000000000000000000000000000000000000000000000110000000000000
1100000000000000000000000000000000000000000000000000000000001100000000000000000000011000000000000000000000000000000000000000000000000000000000000110000000000000
1100000000000000000000000000000000000000000000000000000000001100000000000000000000011000000000000000000000000000000000000000000000000000000000000110000000000000
1100000000000000000000000000000000000000000000000000000000001100000000000000000000011000000000000000000000000000000000000000000000000000000000000110000000000000
1100000000000000000000000000000000000000000000000000000000001100000000000000000000011000000000000000000000000000000000000000000000000000000000000110000000000000
1100000000000000000000000000000000000000000000000000000000001100000000000000000000011000000000001111111111111111111111100000000000000000000000000110000000000000
1100000000000000000000000000000000000000000000000000000000001100000000000000000000011000000000001111111111111111111111100000000000000000000000000110000000000000
1100000000000000000000000000000000000000000000000000000000001100000000000000000000011000000000001100000000000000000001100000000000000000000000000110000000000000
1100000000000000000000000000000000000000000000000000000000001100000000000000000000011000000000001100000000000000000001100000000000000000000000000111111111111111
1111111111111111111111111111111111111111111111111100000000001111111111111111111111111000000000001100000000000000000001100000000000000000000000000111111111111111
1111111111111111111111111111111111111111111111111100000000001111111111111111111111111000000000001100000000000000000001100000000000000000000000000000000000000000
0000000000000000000000000000000000000000000000001100000000000000000000000000000000000000000000001100000000000000000001100000000000000000000000000000000000000000
0000000000000000000000000000000000000000000000001100000000000000000000000000000000000000000000001100000000000000000001100000000000000000000000000000000000000000
0000000000000000000000000000000000000000000000001100000000000000000000000000000000000000000000001100000000000000000001100000000000000000000000000000000000000000
0000000000000000000000000000000000000000000000001100000000000000000000000000000000000000000000001100000000000000000001100000000000000000000000000000000000000000
0000000000000000000000000000000000000000000000001100000000000000000000000000000000000000000000001100000000000000000001100000000000000000000000000000000000000000
0000000000000000000000000000000000000000000000001100000000000000000000000000000000000000000000001100000000000000000001100000000000000000000000000000000000000000
0000000000000000000000000000000000000000000000001100000000000000000000000000000000000000000000001100000000000000000001100000000000000000000000000000000000000000
0000000000000000000000000000000000000000000000001100000000000000000000000000000000000000000000001100000000000000000001100000000000000000001111111111111111111111
0000000000000000000000000000000000000000000000001111111111111111111111111111111111111111111111111100000000000000000001100000000000000000001111111111111111111111
0000000000000000000000000000000000000000000000001111111111111111111111111111111111111111111111111100000000000000000001100000000000000000001100000000000000000000
0000000000000000000000000000000000000000000000000000000000000000000000000000000000000000000000000000000000000000000001100000000000000000001100000000000000000000
0000000000000000000000000000000000000000000000000000000000000000000000000000000000000000000000000000000000000000000001100000000000000000001100000000000000000000
0000000000000000000000000000000000000000000000000000000000000000000000000000000000000000000000000000000000000000000001100000000000000000001100000000000000000000
0000000000000000000000000000000000000000000000000000000000000000000000000000000000000000000000000000000000000000000001100000000000000000001100000000000000000000
