160
36
1111111111111111111111111111111111111111111111111111111111111111111111111111111111111111111111111111111111111111111111111111111111111111111111111111111111111111
1111111111111111111111111111111111111111111111111111111111111111111111111111111111111111111111111111111111111111111111111111111111111111111111111111111111111111
0000000000000000000000000000000000000000000000000000000000001111111111111111111111111000000000000000000000000000000000000000000000000000000000000111111111111111
0000000000000000000000000000000000000000000000000000000000001111111111111111111111111000000000000000000000000000000000000000000000000000000000000111111111111111
0000000000000000000000000000000000000000000000000000000000001111111111111111111111111000000000000000000000000000000000000000000000000000000000000111111111111111
0000000000000000000000000000000000000000000000000000000000001111111111111111111111111000000000000000000000000000000000000000000000000000000000000111111111111111
0000000000000000000000000000000000000000000000000000000000001111111111111111111111111000000000000000000000000000000000000000000000000000000000000111111111111111
0000000000000000000000000000000000000000000000000000000000001111111111111111111111111000000000000000000000000000000000000000000000000000000000000111111111111111
0000000000000000000000000000000000000000000000000000000000001111111111111111111111111000000000000000000000000000000000000000000000000000000000000111111111111111
0000000000000000000000000000000000000000000000000000000000001111111111111111111111111000000000000000000000000000000000000000000000000000000000000111111111111111
1111111111111111000000000000000000000111111111111111111111111111111111111111111111111000000000000000000000000000000000000000000000000000000000000111111111111111
1111111111111111000000000000000000000111111111111111111111111111111111111111111111111000000000000000000000000000000000000000000000000000000000000111111111111111
1100000000000000000000000000000000000000000000000000000000001111111111111111111111111000000000000000000000000000000000000000000000000000000000000111111111111111
1100000000000000000000000000000000000000000000000000000000001111111111111111111111111000000000000000000000000000000000000000000000000000000000000111111111111111
1100000000000000000000000000000000000000000000000000000000001111111111111111111111111000000000000000000000000000000000000000000000000000000000000111111111111111
1100000000000000000000000000000000000000000000000000000000001111111111111111111111111000000000000000000000000000000000000000000000000000000000000111111111111111
1100000000000000000000000000000000000000000000000000000000001111111111111111111111111000000000001111111111111111111111100000000000000000000000000111111111111111
1100000000000000000000000000000000000000000000000000000000001111111111111111111111111000000000001111111111111111111111100000000000000000000000000111111111111111
1100000000000000000000000000000000000000000000000000000000001111111111111111111111111000000000001111111111111111111111100000000000000000000000000111111111111111
1100000000000000000000000000000000000000000000000000000000001111111111111111111111111000000000001111111111111111111111100000000000000000000000000111111111111111
1111111111111111111111111111111111111111111111111100000000001111111111111111111111111000000000001111111111111111111111100000000000000000000000000111111111111111
1111111111111111111111111111111111111111111111111100000000001111111111111111111111111000000000001111111111111111111111100000000000000000000000000000000000000000
1111111111111111111111111111111111111111111111111100000000000000000000000000000000000000000000001111111111111111111111100000000000000000000000000000000000000000
1111111111111111111111111111111111111111111111111100000000000000000000000000000000000000000000001111111111111111111111100000000000000000000000000000000000000000
1111111111111111111111111111111111111111111111111100000000000000000000000000000000000000000000001111111111111111111111100000000000000000000000000000000000000000
1111111111111111111111111111111111111111111111111100000000000000000000000000000000000000000000001111111111111111111111100000000000000000000000000000000000000000
1111111111111111111111111111111111111111111111111100000000000000000000000000000000000000000000001111111111111111111111100000000000000000000000000000000000000000
1111111111111111111111111111111111111111111111111100000000000000000000000000000000000000000000001111111111111111111111100000000000000000000000000000000000000000
1111111111111111111111111111111111111111111111111100000000000000000000000000000000000000000000001111111111111111111111100000000000000000000000000000000000000000
1111111111111111111111111111111111111111111111111100000000000000000000000000000000000000000000001111111111111111111111100000000000000000001111111111111111111111
1111111111111111111111111111111111111111111111111111111111111111111111111111111111111111111111111111111111111111111111100000000000000000001111111111111111111111
1111111111111111111111111111111111111111111111111111111111111111111111111111111111111111111111111111111111111111111111100000000000000000001111111111111111111111
1111111111111111111111111111111111111111111111111111111111111111111111111111111111111111111111111111111111111111111111100000000000000000001111111111111111111111
1111111111111111111111111111111111111111111111111111111111111111111111111111111111111111111111111111111111111111111111100000000000000000001111111111111111111111
1111111111111111111111111111111111111111111111111111111111111111111111111111111111111111111111111111111111111111111111100000000000000000001111111111111111111111
1111111111111111111111111111111111111111111111111111111111111111111111111111111111111111111111111111111111111111111111100000000000000000001111111111111111111111
