160
36
3333333333333333333333333333333333333333333333333333333333330000000000000000000000000000000000000000000000000000000000000000000000000000000000000000000000000000
3333333333333333333333333333333333333333333333333333333333330000000000000000000000000000000000000000000000000000000000000000000000000000000000000000000000000000
0440000000000000000000000000000000000000000000000000000000330000000000000000000000000000000000000000000000000000000000000000000000000000000000000000000000000000
0440000000000000000000000000000000000000000000000000000000330000000000000000000000000000000000000000000000000000000000000000000000000000000000000000000000000000
0440000000000000000000000000000000000000000000000000000000330000000000000000000000000000000000000000000000000000000000000000000000000000000000000000000000000000
0440000000000000000000000000000000000000000000000000000000330000000000000000000000000000000000000000000000000000000000000000000000000000000000000000000000000000
0440000000000000000000000000000000000000000000000000000000330000000000000000000000000000000000000000000000000000000000000000000000000000000000000000000000000000
0440000000000000000000000000000000000000000000000000000000330000000000000000000003333333333333333333333333333333333333333333333333333333333000000000000000000000
2222222222222222000000000000000000000222222222222222222222330000000000000000000003333333333333333333333333333333333333333333333333333333333000000000000000000000
3333333333333333000000000000000000000333333333333333333333330000000000000000000003300000004400000000000000000000000000000000000000000000033000000000000000000000
3300000000000000000000000000000000055000000000044000000000330000000000000000000003300000004400000000000000000000000000000000000000000000033000000000000000000000
3300000000000000000000000000000000000000000000044000000000330000000000000000000003300000004400000000000000000000000000000000000000000000033000000000000000000000
3300000000000000000000000000000005500000000000044000000000330000000000000000000003300000004400000000000000000000000000000000000000000000033000000000000000000000
3300000000000000000000000000000000000000000000044000000000330000000000000000000003300000004400000000000000000000000000000000000000000000033000000000000000000000
3300000000000000000000000000000550000000000000044000000000330000000000000000000003300000004400000000000000000000000000000000000000000000033333333333333333333333
3300000000000000000000000000000000000000000000044000000000330000000000000000000003300000000222222222222222222222220000000000000000000000033333333333333333333333
3322222222222222222222222222222222222222222222222200000000330000000000000000000003300000000333333333333333333333330000000000000000000004400000000000000000600000
3333333333333333333333333333333333333333333333333300000000330000000000000000000003300000000330000000000000000000330000000000000000000004400000000000000000600000
0000000000000000000000000000000000000000000000003300000000330000000000000000000003300000000330000000000000000000330000000000000000000004400000000000000000600000
0000000000000000000000000000000000000000000000003300000000330000000000000000000003300000000330000000000000000000330000000000000000000004400000000000000000600000
0000000000000000000000000000000000000000000000003300000000333333333333333333333333300000000330000000000000000000331110000000000000000004400000000000000000600000
0000000000000000000000000000000000000000000000003300000000333333333333333333333333300000000330000000000000000000330001110000000000000004400000000000000000600000
0000000000000000000000000000000000000000000000003300000000000000000000000000000000000000000333333333330000000000330000001110000000000000222222222222222222222222
0000000000000000000000000000000000000000000000003300000000000000000000000000000000000000000333333333330000000000330000000001110000000000333333333333333333333333
0000000000000000000000000000000000000000000000003300000000000000000000000000000000000000000000000000330000000000330000000000001110000000330000000000000000000000
0000000000000000000000000000000000000000000000003300000000000000000000000000000000000000000000000000330000000000330000000000000001110000330000000000000000000000
0000000000000000000000000000000000000000000000003300000000000000000000000000000000000000000000000000330000000000330000000000000000001100330000000000000000000000
0000000000000000000000000000000000000000000000003300000000000000000000000000000000000000000000000000330000000000330000000000000000000011330000000000000000000000
0000000000000000000000000000000000000000000000000322222222222222222222222222222222222222222222222222330000000000330000000000000000000000330000000000000000000000
0000000000000000000000000000000000000000000000000333333333333333333333333333333333333333333333333333330000000000330000000000000000000000330000000000000000000000
0000000000000000000000000000000000000000000000000000000000000000000000000000000000000000000000000000000000000000330000000000000000000000330000000000000000000000
0000000000000000000000000000000000000000000000000000000000000000000000000000000000000000000000000000000000000000330000000000000000000000330000000000000000000000
0000000000000000000000000000000000000000000000000000000000000000000000000000000000000000000000000000000000000000330000000000000000000000330000000000000000000000
0000000000000000000000000000000000000000000000000000000000000000000000000000000000000000000000000000000000000000330000000000000000000000330000000000000000000000
0000000000000000000000000000000000000000000000000000000000000000000000000000000000000000000000000000000000000000330000000000000000000000330000000000000000000000
0000000000000000000000000000000000000000000000000000000000000000000000000000000000000000000000000000000000000000330000000000000000000000330000000000000000000000
